OOOOOOOOOO
O O    O O
O . OO   O
O O O    O
O OOOO O.O
O_O O    *
O OOOOOO.O
O O      O
O O OOOOOO
O . O    O
OOOOOOOOOO
